What does the fox say?
1
180
WWWWOWWW
PDGDDDWW
WWWW WWW
WWWW DDX
WWWWFWWW